1111111111111111111111111111
1000P00000000000000C00000001
1000000000000000000000000001
1000000000000000000000000001
1E0000000000000000000000C001
1000000000000000000000000001
10000000000000000C0000000001
1111111111111111111111111111