1111111111111111
1000P00000000001
1000000000000001
1000000000P00001
1E00C00000000001
1C00000000000001
1C00000000000001
1111111111111111