111111
100001
1000E1
1000P1
1100C1
111110