111111
1000P1
100001
100001
1E0001
111111