111111
1000P1
100001
101001
1E0001
111111111111111